Descriptor,Wins,Losses,Ties,Points,Rank
ConvNeXt_base,23,0,37,23,16.0
Swin_V2_s,20,0,40,20,15.0
Morphological,12,0,48,12,14.0
EfficientNet_V2_s,8,0,52,8,13.0
HOG,7,0,53,7,12.0
ResNet50,6,1,53,5,11.0
FDTA,3,0,57,3,10.0
LBP-8-2-nri-uniform,4,2,54,2,8.5
MobileNet_V2,4,2,54,2,8.5
LBP-8-1-nri-uniform,1,4,55,-3,7.0
Gabor,0,10,50,-10,6.0
LBP-8-1-ror,0,11,49,-11,5.0
LBP-8-2-ror,0,14,46,-14,3.5
LBP-8-2-uniform,0,14,46,-14,3.5
DCF,0,15,45,-15,1.5
LBP-8-1-uniform,0,15,45,-15,1.5
